#######........
#5...5########.
#.....#.....3#.
#.....#......#.
#.....#......#.
#............#.
#.........####.
#....4....718.#
######.......4#
..#8..........#
..#.......#...#
..#.......#...#
..#16....2#...#
..#########...#
..........#####

1.3.
.8..
4.65
1.75
.8..
4.2.

1 h 1RD
2 h 1LU
3 h 1LD
4 h 1RU
5 o 2L
6 c 1D 1LU 2R
7 c 1U 1LD 2R
8 c 1RU 1RD 1LD 1LU