###########
#...#...#.#
#.7.......#
#.#..8#.1.#
#4.3......#
#...#...#.#
#.........#
#.#.6.#...#
#5.....2..#
#...#...#.#
###########

.25..
13678
.4...

1 h 1R
2 h 1D
3 c 1U 1R 1D 1L
4 h 1U
5 o 2D
6 c 1R 1L 2U
7 o 1R 1L
8 h 1L