###############
#58.4#.......6#
#..#####......#
#...........#.#
#......###..#.#
#...#.......###
#...#.......#.#
#.#.#.....#.#.#
#.#.......#...#
###.......#...#
#.#..###......#
#.#...........#
#......#####..#
#......23#1.7.#
###############

1..678
.45...
3..2..

1 h 1RD
2 h 1LU
3 h 1RU
4 c 1LD 1LU 2R
5 c 1RU 1RD 2L
6 n 1LD 2R
7 c 2R 2L
8 s 2L