###############
##49........6##
#..1........a.#
#..#.#...#.#..#
#...#.....#...#
#5.#.#...#.#..#
#8............#
##...........##
#7............#
#..#.#...#.#..#
#...#.....#...#
#..#.#...#.#..#
#3............#
##.2.........##
###############

1.2
.a.
79.
635
84.

1 h 1RD
2 h 1LD
3 c 1U 1R 1D 1L
4 h 1U
5 h 1L
6 c 1U 1R 2D
7 o 1R 1D
8 o 2U
9 c 1D 1L 2U
a c 1RU 1LU 2D