###############
#3..........48#
#1..........4.#
#.#..#....#...#
#.#..#........#
#.#..#.#......#
#..##2....#...#
#.............#
#....#79...#..#
#..#.#6###....#
#....###.#....#
#.#...........#
#...#.....#.a5#
#............b#
###############

..8..
a.4..
.5.69
.4.72
3.b..
..1..

1 h 1U
2 o 2L
3 h 1RU
4 c 1RD 1LD 2U
5 c 1RU 1LU 2D
6 n 1R 1D 1LU
7 c 1U 1LD 2R
8 o 2D
9 h 1L
a h 1RD
b n 1RU 1D 1LU