#############
##..3#..#..##
#...#..#....#
#........#..#
#1#.#...#..##
##...#....#.#
#....2......#
#.#....#..4##
##..#...#.#.#
#..#........#
#....#..#...#
##..#..#...##
#############

..3
12.
..4

1 h 1R
2 n 1RU 1RD 1L
3 h 1LD
4 h 1LU