#############
#..##.#.##..#
#...#.4.#...#
#....3...3.3#
##..#...#..##
#7.##6..##..#
#8....#.....#
#..##...##..#
##..#22.#4.##
#...2.......#
#..5#..1#...#
#.4##.#.##..#
#############

.25.22.
1367338
.4..44.

1 h 1R
2 h 1D
3 c 1U 1R 1D 1L
4 h 1U
5 o 2D
6 c 1R 1L 2U
7 o 1R 1L
8 h 1L