.....#.....
....###....
...#####...
..#######..
.##1223.##.
##.2#4#2.##
.##25246##.
..#######..
...#####...
....###....
.....#.....

32221
4...4
62225

1 cr 1D 1L
2 cr 1R 1L
3 cr 1R 1D
4 cr 1U 1D
5 cr 1U 1L
6 cr 1U 1R