#############
#...........#
###..###..###
#.....#.....#
#.###...###.#
#.#2..#...#.#
#1435###....#
#.#...#...#.#
#.###...###.#
#.....#.....#
###..###..###
#...........#
#############

.2..
1345

1 h 1R
2 o 2D
3 c 1R 1L 2U
4 o 1R 1L
5 h 1L