#############
#1..#...#..8#
#.#3.4#7.3#.#
#..#.#.#.#..#
#...#.5.#...#
##.........##
#...##.##...#
#2.#..6..#.9#
#############

1.5.8
.3.3.
.467.
2...9

1 h 1RD
2 h 1RU
3 c 1RU 1LU 2D
4 c 1R 1LD 2U
5 o 1RD 1LD
6 b 1L 1R
7 c 1RD 1L 2U
8 h 1LD
9 h 1LU