#############
#.b.4...5...#
#.####..##..#
#..3......3.#
##.....7..#.#
#..#.#.#2.#.#
#.1..#.#..#.#
#c#......9..#
#.#....8....#
#....#..#a.##
#..#.#..#...#
#....#6.#...#
#############

1.58..
2469bc
3.7...
.3.a..

1 h 1RD
2 h 1R
3 h 1RU
4 c 1R 1LD 1L 1LU
5 h 1D
6 c 1U 1R 1D 1L
7 n 1U 1RD 1LD
8 o 2D
9 c 1R 1L 2U
a h 1LU
b o 1R 1L
c h 1L