....#######
....#...#.#
#######.#.#
#...##....#
###1#.....#
#......4#.#
#..#...#3.#
#.2########
#..5.#.....
####.#.....
#....#.....
######.....

1.4
.3.
2.5

1 cl 1RD
2 cl 1RU
3 c 1RU 1RD 1LD 1LU
4 h 1LD
5 cl 1LU