########...
#...1..##..
##5.##.4###
.##.3.....#
..#.#.....#
.##1##..#3#
.#...5#2###
.#......#.#
.#3...3..2#
.#4.#.###.#
.######.###

.22.
1335
1335
.44.

1 h 1R
2 h 1D
3 c 1U 1R 1D 1L
4 h 1U
5 h 1L