####....#####
#31#....#.7.#
#..######.#.#
#..##28##.#.#
#..........b#
#.##....##a.#
#..6.##..5#.#
#4##....##..#
#....##...#.#
#.#.c.....#.#
#.6##..##...#
#....d2....9#
#############

..4.8.
..52..
12..6d
..67..
.3..9b
....ac

1 h 1R
2 n 1RU 1RD 1L
3 h 1RU
4 o 2D
5 c 1R 1LD 2U
6 c 1LD 1LU 2R
7 c 1RU 1RD 2L
8 h 1LD
9 c 1R 1RD 1D 1LU
a h 1U
b h 1L
c h 1LU
d o 2L