###############
##584.......2##
#2#.........#6#
#............9#
#.............#
#.............#
#.....#.#.....#
#......#......#
#.....#.#.....#
#.............#
#.............#
#.............#
#7#.........#1#
##.........63##
###############

..5..
1.962
.8...
3.762
..4..

1 h 1RD
2 h 1L
3 h 1RU
4 o 2U
5 o 2D
6 o 1R 1L
7 c 1R 1LU 2D
8 c 1RU 1RD 1LD 1LU
9 c 1R 1LD 2U