##########.
#...#.1..##
#...#.#...#
#2.##.##..#
##.6......#
##........#
#...##.##.#
#....#5#..#
###...3#..#
..#....4..#
..#########

1..
2..
.56
3..
4..

1 h 1D
2 o 1U 1RD
3 o 1RU 1D
4 h 1U
5 c 1LD 1LU 2R
6 o 2L