###.....###
#.#.....#.#
#2#######.#
#......#..#
##..4.#...#
#.#....5#3#
#...#....##
#..#....61#
#.#######.#
#.#.....#.#
###.....###

1..5
.34.
2..6

1 h 1RD
2 h 1RU
3 c 1LD 1LU 2R
4 c 1RU 1RD 2L
5 h 1LD
6 h 1LU