###############
#d376.........#
#2#........c#.#
#a.#6......#b.#
#...#.....#..7#
#....#...#8..f#
#.....#.#....5#
#......#.....3#
#.....#.#.....#
#....#...#....#
#...#.....#1..#
#..#.......#..#
#.#.........#9#
#.4........e47#
###############

.2.3.3..
..6.4...
.4.6.b..
7.7.c.ad
...789..
..1f..e5

1 h 1R
2 h 1RD
3 h 1LD
4 o 1RU 1LD
5 h 1L
6 c 1RU 1RD 1LD 1LU
7 h 1RU
8 c 1U 1LD 2R
9 c 1RU 1RD 2L
a c 1LD 1LU 2R
b o 1RD 1LD
c c 1RU 1D 1LD 1LU
d o 2L
e o 1R 1LU
f o 1RU 1L