#############
#1.#.......4#
#..#3..#....#
#.....#...###
#.....#...4.#
#.#..7#6....#
#..#######..#
#....9#8..#.#
#.1...#.....#
###...#.....#
#....#..5#..#
#2.......#.5#
#############

1..6..
.3.789
1.4...
.4.5..
2.5...

1 h 1RD
2 h 1RU
3 o 1RD 1LU
4 c 1RU 1RD 1LD 1LU
5 h 1LU
6 o 2D
7 c 1R 1LD 2U
8 o 1R 1L
9 h 1L