###############
#.2.5..#..3..4#
#2.#...#...#..#
#.###.12..###.#
#.3#....4..#..#
#.......3.....#
###.2..4....###
#....3.......7#
#8.#.......#.6#
#.###....2###.#
#..#4..#4..#..#
#.....3#......#
###############

..527..
.22622.
1333338
.44444.

1 h 1R
2 h 1D
3 c 1U 1R 1D 1L
4 h 1U
5 h 1RD
6 c 1U 1RU 1D 1LU
7 h 1LD
8 h 1L