......#######
#######c#...#
#..34#......#
#.......##7##
#...##d1a###.
##6..##....#.
###...e.#..#.
#1.........#.
#..##...##.#.
#..b##...####
#..8......5.#
#######9#..2#
......#######

.2.8..
..59..
.16.bd
..7ac.
13...e
.4....

1 h 1R
2 h 1RD
3 n 1RU 1D 1L
4 h 1U
5 c 1D 1LU 2R
6 c 1U 1L 2D
7 c 1R 1LD 2U
8 h 1D
9 c 1U 1RD 2L
a b 1L 1R
b c 1R 1LU 2D
c c 1RD 1L 2U
d h 1L
e h 1LU