#############
#...........#
#...#..6#...#
#4.#.7...#..#
#.#.##.##.#.#
#..2........#
###5##.##.###
#...........#
#.#.##1##.#.#
#..#31...#1.#
#...#..5#...#
#3..5.......#
#############

...1.7
.1..3.
1.46.5
.3..5.
2.5...

1 h 1RD
2 h 1RU
3 c 1RU 1RD 1LD 1LU
4 c 1LD 1LU 2R
5 h 1LU
6 c 1RU 1RD 2L
7 h 1LD