#############
#...#####...#
#.#.........#
#.#.2#...#..#
####.###6#..#
#......#.##.#
#3#.......#.#
####.####...#
#.#....#....#
#...#.....#.#
#..###.1.##5#
#.7#....##4.#
#############

...3.
12457
...6.

1 h 1R
2 c 1L 3R
3 h 1D
4 c 1R 3L
5 c 1U 1R 1D 1L
6 h 1U
7 h 1L