.........####
####.....#..#
#..#.....#..#
#..##...##.5#
#..4#####...#
#.#.#.3#....#
#......#.6..#
#..#.#...#..#
#2..........#
#...#.#...#.#
######1...#.#
.....########

.2..
1356
.4..

1 h 1R
2 h 1D
3 c 1U 1R 1D 1L
4 h 1U
5 o 1R 1L
6 h 1L