.##########
.#........#
.#.1#.....#
##.##.6#.##
#.....##7#.
##.....####
#4.#......#
###5.#.3#.#
..#..####.#
..#..#..#.#
..#..#..#.#
..####..#2#
........###

127
.3.
.4.
.5.
.6.

1 h 1RD
2 h 1D
3 c 1U 1RU 1D 1LU
4 c 1U 3D
5 c 1D 3U
6 h 1U
7 h 1LD