###############
#.....1#1.....#
#.....###.....#
#.............#
#.............#
#7#.........#2#
###.........###
###.........###
#6#.........#3#
#.............#
#.............#
#.....###.....#
#.....5#4.....#
###############

..1.
76.1
..5.
..4.
.3.2

1 h 1LD
2 h 1LU
3 h 1RU
4 c 1RD 1LD 2U
5 c 1RU 1LU 2D
6 c 1RU 1RD 2L
7 o 2R