...##########
...#....3#..#
...#.#...#..#
...#..#.....#
####...#...##
#..4#..4#...#
#...2#1..#.##
#..#..#.5#.#.
##1##..#.###.
.#....3...#..
.#....#.6.#..
.######.5.#..
......#####..

.2.5.5
..4.3.
.3.4..
1.1.6.

1 h 1RU
2 h 1RD
3 o 1RU 1LD
4 c 1RU 1RD 1LD 1LU
5 h 1LD
6 h 1LU