##########...
##1..3#..#...
#.#...#..####
#.#.........#
#.##..#.#.#.#
#2........#.#
#.######.##.#
#.15.......7#
#4.#.#...####
#..#.#...#...
#..#.#...#...
#.6#.#...#...
#..#.#...#...
###......#...
..########...

.2..
13..
..67
15..
.4..

1 h 1R
2 h 1D
3 n 1U 1RD 1L
4 h 1U
5 n 1RU 1D 1L
6 c 1LD 1LU 2R
7 o 2L