###########
#5..#.....#
#9.3#....2#
#.....#####
#.........#
#.........#
#...#.....#
#.1.#4#...#
#.###1#...#
#.87####..#
#...#.....#
#.6.#.....#
###########

..11..
..23..
..45..
67..89
......

1 o 2D
2 c 1R 1D 2U
3 c 1D 1L 2U
4 c 1U 1LD 2R
5 c 1U 1RD 2L
6 h 1R
7 o 1RU 1L
8 o 1R 1LU
9 h 1L