#############
#.#..##...#.#
##..#.....#.#
##....#..#..#
#.5..1#.2..7#
###....#.#..#
#..#......###
#.4..3.#6..3#
#.##.##.....#
##......#.#.#
#.7##5.#2.#1#
#.#....#.#..#
#############

.1..7.
1.46.7
.3..3.
2.52.5

1 h 1RD
2 h 1RU
3 c 1RU 1RD 1LD 1LU
4 c 1LD 1LU 2R
5 h 1LU
6 c 1RU 1RD 2L
7 h 1LD