#############
#...........#
#....#2#1...#
#3...#.#....#
#.####3####.#
#2..........#
####..#.2####
#1.........1#
#.####.####.#
#..2.#.#....#
#1...#.#...3#
#..3........#
#############

1111
3333
2222

1 f 1D
2 f 1U
3 c 1U 1R 1D 1L