#############
#6...8#5...7#
#.#..###..#.#
##6...#...9##
.#..#1#3#..#.
.##..###..##.
.#....#....#.
##1...#...2##
#.#.......#.#
#4.........9#
#############

..6.
.2..
13.6
..7.
..8.
14.9
.5..
..9.

1 o 2R
2 o 1RU 1D
3 c 1U 1RD 2L
4 c 1RU 1D 2L
5 o 1U 1RD
6 h 1LD
7 c 1RU 1LU 2D
8 c 1RD 1LD 2U
9 h 1LU