#############
#..42.....3.#
#.#..####.###
###2...#....#
#.6..#.....4#
#.##.#.##.4.#
#.#..#..#.###
###.3#.5.3#.#
#1..........#
#4...#..2...#
#..###2##.#.#
#....#.3..#.#
#############

.2222.
133336
.4445.
....4.

1 h 1R
2 h 1D
3 c 1U 1R 1D 1L
4 h 1U
5 o 1U 1D
6 h 1L