#############
#...3.#5...1#
#.###.#.###.#
#.#..4#...#.#
#.#...#...#.#
#.....#.....#
####2....####
#.....#.....#
#.#...#...#.#
#.#..6#..4#.#
#.###.#.###2#
#....3#.....#
#############

.2.2.
13536
.4.4.

1 h 1R
2 h 1D
3 c 1U 1R 1D 1L
4 h 1U
5 o 1R 1L
6 h 1L