..####.......
..#..####....
..##....####.
..#.3.#.#..#.
..###.#....#.
..#...1...##.
..##2......##
###.....#...#
#.###...#####
#.........#..
###########..

1
2
3

1 h 1D
2 c 1U 3D
3 n 3U