#############
#1.#.1.2.#.3#
##...#.#...##
#.....#.....#
#4.#5...6#.7#
#...#...#...#
##...#8#...##
#...#...#...#
#9.#a...b#.c#
#.....#.....#
##...#.#...##
#7.#.d.3.#.8#
#############

..988.
.4.271
.65.d.
c..b71
3.a.3.

1 h 1L
2 c 1U 1R 1LD 1LU
3 h 1U
4 o 2D
5 c 1L 1RU 1RD
6 c 1R 1LD 2U
7 c 1U 1R 1D 1L
8 h 1D
9 h 1RD
a h 1RU
b n 1R 1LD 1LU
c o 1D 1RU
d b 1U 1D