##############
#..3#....6#..#
#..5#........#
#...#........#
#...#........#
#...#...#.####
#78..........#
##.......3#..#
#.4....#....##
#.#..#.#.....#
#91..#.#2....#
##############

1...5
.478.
.3.3.
2.9.6

1 h 1RD
2 h 1RU
3 c 1RD 1LD 2U
4 c 1R 1LU 2D
5 h 1LD
6 h 1LU
7 b 1L 1R
8 c 1RU 1L 2D
9 s 1RU 1LU