##############
#..4#..#....6#
#.........#..#
#..#5........#
#3..7#.#.....#
##...##...#..#
##...#.#..#..#
#............#
#............#
#.#..........#
#.2.8#..#1...#
##############

8...7
.132.
6.4.5

1 c 1R 1RD 1LD 1LU
2 c 1RU 1RD 1LD 1L
3 b 1L 1R
4 o 1RU 1LU
5 h 1LU
6 h 1RU
7 h 1LD
8 h 1RD