.......###...
.#######2####
.#.3....5...#
##.a#.....#.#
#..#4#...#7.#
#.#...#.#.5.#
#...........#
#...#.....#.#
#87#6#...#..#
#.#..6#.#bc.#
#....#...#8.#
###.......#.#
..#..9......#
..####1######
.....###.....

....5...
12.574..
..3669..
..c78.ab
...8....

1 h 1R
2 o 1RD 1L
3 c 1R 1LU 2D
4 o 2D
5 h 1D
6 c 1U 1R 1D 1L
7 o 1U 1D
8 h 1U
9 c 1RD 1L 2U
a o 1R 1LU
b h 1L
c o 2U