#############
#....4#23...#
#.....#....1#
#...#####...#
#.....#.....#
#.....#.....#
#...........#
#...........#
#...........#
#############

.1.
.2.
3.4

1 o 2D
2 c 1RD 1LD 2U
3 cl 1RU
4 cl 1LU