###########
#.2#.5....#
#.##4..##.#
#.....3.###
#..###....#
#..#....###
#....#....#
####..#...#
#72.....#.#
#..#.31.#.#
#6##..#.#4#
#.....#...#
###########

.22..
13357
.446.

1 h 1R
2 h 1D
3 c 1U 1R 1D 1L
4 h 1U
5 c 1R 1L 2D
6 o 2U
7 h 1L