.###########.
##.........##
#..#..###.1.#
#.##..#8..#.#
#3#...#..##.#
#.........5.#
#...###.5####
#.#2#7..#4..#
#6#.#.......#
#.#.....#...#
#......##...#
##.....#...##
.###########.

1..6
.25.
.3.7
.45.
...8

1 h 1RD
2 c 1D 1LU 2R
3 b 1U 1D
4 n 1U 2R
5 c 1RU 1RD 2L
6 h 1LD
7 s 1LD 1LU
8 h 1LU