###############
#...........62#
###...#....7###
..#...#....#..#
..#...#....#..#
..#.###....#..#
..#..1#....#..#
..#####.......#
..#89#........#
..#..#........#
###..#........#
#5#.......##..#
#43.......6####
###########....

.9..
.756
.82.
136.
.4..

1 h 1R
2 o 2L
3 c 1U 1R 1D 1L
4 h 1U
5 o 1R 1L
6 h 1L
7 c 1R 1D 2U
8 c 1U 1D 2R
9 o 2D