###############
###3...#....###
##.....#..6.5##
#...#.....#...#
#...##.2.##...#
#....##.##....#
###1...3....###
#....##.##....#
#...##.4.##...#
#.4.#.....#...#
##.....#.....##
###....#....###
###############

6251
.33.
.44.

1 o 2L
2 c 1R 1D 2L
3 o 1U 1D
4 h 1U
5 c 1D 1L 2R
6 o 2R