#############
#..6#.#.....#
#..4##...#..#
#...#...3#..#
#.....#..####
#........#...
#........#...
#...#....#...
#...#....#...
#...#....#...
#...#.#.5#...
#...#..#2#...
#..1#...##...
##########...

1..5
.34.
6..2

1 h 1RD
2 h 1LU
3 c 1LD 1LU 2R
4 c 1RU 1RD 2L
5 cl 1LD
6 cl 1RU