#############
####..##....#
##.....#.#..#
#.....6#.####
#.#3#.4.5..2#
#.#4###..1..#
###..2....###
#.....###.#.#
#.....3.#.#.#
####.#.....7#
#..#.#.....##
#....##..####
#############

.2.2.
13537
.464.

1 h 1R
2 h 1D
3 c 1U 1R 1D 1L
4 h 1U
5 c 1R 1L 2D
6 o 2U
7 h 1L