.#######.....
.#.....#.....
.#..6..######
.#.##..#9...#
.#.12.7####.#
.###...#....#
##.##..#.4..#
#.....#2.#..#
#........#5.#
#.3a#5.#.##.#
#####..#....#
...#...#8####
...#######...

.22..
.36.9
1..8.
.47.a
.55..

1 o 1RU 1RD
2 h 1D
3 c 1U 1LD 2R
4 c 1D 1LU 2R
5 h 1U
6 c 1U 1RD 2L
7 c 1RU 1D 2L
8 c 1RU 1RD 1LD 1LU
9 h 1LD
a h 1LU