....#########
.####.....2.#
.#..#..###.6#
.#.4.......##
##.###1.#...#
#..........6#
#.......4...#
#8#.#.###...#
###........##
..#.....7#3#.
..#7###.####.
..#.5...#....
..#######....

...4.8
..4.6.
...6.7
..5.7.
12....
.3....

1 h 1R
2 c 1RU 1L 2D
3 o 2U
4 h 1RD
5 o 1RU 1LD
6 c 1RU 1RD 1LD 1LU
7 h 1LU
8 h 1LD