###############
#.#...........#
#........#.#..#
#.........#...#
#.#......#.#..#
#6#...........#
###...........#
#......#.#....#
#.......#.....#
#......#.#...2#
##31..........#
#.....7.#...25#
#....##.##..###
#..##.###....4#
#####....######

..6..
12423
..7..
..5..

1 h 1R
2 o 1R 1L
3 h 1L
4 p 1R 1D 1L 2U
5 h 1U
6 o 2D
7 o 1U 1D