..########...
..#..#...#...
###..5...####
#..8###..9..#
#..a...3#...#
####.#..#6..#
#b...#.###..#
#..........4#
##.####....##
#4.#.7...#..#
#.....#..#..#
####.1#.2#.##
...##########

1...8.
.357..
.4.4..
2.6.9b
....a.

1 h 1RD
2 h 1RU
3 c 1R 1LU 2D
4 c 1RD 1LD 2U
5 b 1L 1R
6 o 1RU 1LU
7 c 1RU 1L 2D
8 h 1LD
9 c 1D 1LU 2R
a h 1U
b o 2L