#############
#4....#....2#
#..##.#.##..#
##.#.....#.##
#..#.....#..#
#.##..#..####
#....###....#
#.##..#..##.#
#..#.....#..#
##.#.....#.##
#..##.#.##..#
#3....#....1#
#############

1.
24
3.

1 h 1D
2 c 1U 1D 2R
3 h 1U
4 o 2L