###########
#.........#
#.##...##.#
#2.....3..#
#.###.###.#
#4...1....#
#5###2###.#
#.........#
#.##...##.#
#..6......#
###########

.22.
1356
.4..

1 h 1R
2 h 1D
3 c 1U 1R 1D 1L
4 h 1U
5 c 1U 1L 2R
6 o 2L