#############
#...#..#....#
#.#..#5#....#
#..#...#3.#.#
#......####.#
#.......#1#.#
#.2..#..#...#
#.#####....##
#.4.#..#...#.
#####..#...#.
.......#####.

.2.
135
.4.

1 h 1R
2 h 1D
3 c 1U 1R 1D 1L
4 h 1U
5 h 1L